------------------------------------------------------------------------------------------------------------------------------------------------------------------------------------
------------------------------------------------------------------------------------------------------------------------------------------------------------------------------------
------------------------------------------------------------------------------------------------------------------------------------------------------------------------------------
------------------------------------------------------------------------------------------------------------------------------------------------------------------------------------
-----------------E--------------------------------E-----------------------------------------E---------------------------------------------------------------------------------------
--------------SSSSSSSSSSS------------?QQQQQQ---------SSSSSSSSSSSS----SSSSSSSSSSSSX--------------E-----------------------?------------------------------------------------XX---------
---------------------------------------------------------------------------------X------E-------------------------------E-----------------------------------------------XXX---------
---------------------------------------------------------------------------------X-----------------------------------------E-------------------------------------------XXXX---------
-------------------E----------------------------------------E--------------------X--E-------------------------------------<>--------E--EE-----------------------------XXXXX---------
--------------SSSSSS?SSSS-----QQQ?---S---------------------<>------S------------?X-<>--------------------?QQ--------------[]-------<>--<>---------E------------------XXXXXX---------
-----------------------------------------------------------[]----------------E---X-[]-------------------------------------[]---<>--[]--[]---------------------------XXXXXXX---------
-----------------------------------------------------------[]---------------<>---X-[]-------------------------------------[]---[]--[]--[]--------------------------XXXXXXXX---------
--------------------------------------EE-------------------[]---------------[]---X-[]-E----------------E-E----------------[]---[]--[]--[]-------------------------XXXXXXXXX--------X
XXXXXXXXXXXXXXXXXXXXXXXXX----XXXXXXXXXXXX--------XXXXXXXXXXXXXXXXX----------XXXXXXXXXXXXXXXXXX---XXXXXXXXXXXXXXXXXXXXXXXXXXX---XX--XXXXXXXXXXXXXXXX----XXX----XXXXXXXXXXXXXXXXXX---X
