-------------------------------------------------------------------------------------------------------------------------------------------------------------------------------------------------------------------------------------------------------------------------------------------------------------------------------------------------------------------------------------
-------------------------------------------------------------------------------------------------------------------------------------------------------------------------------------------------------------------------------------------------------------------------------------------------------------------------------------------------------------------------------------
-------------------------------------------------------------------------------------------------------------------------------------------------------------------------------------------------------------------------------------------------------------------------------------------------------------------------------------------------------------------------------------
-------------------------------------------------------------------------------------------------------------------------------------------------------------------------------------------------------------------------------------------------------------------------------------------------------------------------------------------------------------------------------------
-------------------------------------------------------------------------------------------------------------------------------------------------------------------------------------------------------------------------------------------------------------------------------------------------------------------------------------------------------------------------------------
---------------------------------------------------------------------------------------------------------------------------------------------------SSSSSSSS------------------------------------------------------------------------------------------------------------------------------------------------------------------------------------------------------------XXXXXXX-------
-----------------------------------------------------------------------------------------------------------------------------------------------------------------------------------------------------------------------------------------------------------------------------------------------------------------------------------------------------------------------XX---XX-------
------------------------------------------------------------------------------------------------------------------------------------------------------------------------------------------------------------------------------------------------E--------------------------------?----------------------------------------------------------------------------------XXXXXX--XX-------
-----------------------------E----------------------------------------E--S--------------E---------E------------------------------------------------------------------------------SSSSSSSS---------------------------------------------------E--<>------------------------------XXX-----------------------------------------------------------------------------------XXXXX--X--------
----------------------------<>---------------------------------------<<-----E----------<>--------<>-----------------------------------E----------XXXX--S----E---------------------------------------------------------------------------E--<S--[]------------------------------XXX----------------------------------------------------------------E---------------XXXXXXXX-----------
----------------------------[]---------------------------------------Q]----?------------E--------[]----------E-----------------------<>----------XXXX----E-XXX------E------------------------------------------------------------------<>--[]--E]----------------------------XXXXX---------------------------------------------------------------E-----------E-----XXXXXX------------
----------------------------[E----------------------------------------]----------------[]--------Q]---------<XX----------------------SQ----------XXX--------XX----------E----------------------------------XX--------------------------[]--[]--[]---------------------------XXXXXX----------------------X---S-----------------------------------------------]---XXXXXXXXX------------
----------X---E-EE-----XXE--[]----E-E-----------XXXXXXXXX-----EE-E---[]----------------[]----X---[XXE-EE----[XXXX-X--E----EE-E-------[X-----E-EEXXQXX-------XXX-----------X-------XXXX-------X---------EE-XXXX---X---------------EE-E--E]-XXS--[X----XX--EE-E--E---------E-XXXXXXX----XX----------------XXEXXXX-XX-----XXX----------E------E-EE------------------?-XXXXXXX-------]---
XXXXXXXXXXXXXXXXXXXXXXXXXXXXXXXXXXXXXXX-X-XX-XX-XX-XXXXXXXXXXXXXXXXXXXXXXXXXXXXXXXXXXXXXXXXXXXXXXXXXXXXXXXXXXXXXXXXXXXXXXXXXXXXXXXXXXXXXXXXXXXXXXXXXXXXXXXXXXXXXXX-X-XX-X-XX-XXXXXXXXXXXXXXXXX-X-X-XXXXXXXXXXXXXXXXXXX------XXXXXXXXXX-XX--XX--XXXXXXXXXXXXXXXXXXXXXXXXXXXXXXXXXXXXXXXXXXXX---XX---XXXXXXXXXXXXXXXX-----X----XXXXXXXXXXXXXXXXXXXXXXXXXXXXXXXXXXX-X-X-X-XXXXXXXXXXXXXX
