----------------------------------------------------------------------------------------------------------------------------------------------------------------------------------------------------------
----------------------------------------------------------------------------------------------------------------------------------------------------------------------------------------------------------
----------------------------------------------------------------------------------------------------------------------------------------------------------------------------------------------------------
----------------------------------------------------------------------------------------------------------------------------------------------------------------------------------------------------------
----------------------------------------------------------------------------------E-----------------------------------------------------------------------------------------------------------------------
----------------------Q---------------------------------------------------------SSSSSSSS---SSSQ--------------?-----------SSS----SQQS--------------------------------------------------------XX------------
-------------------------------------------------------------------------------------------------------------------------------------------------------------------------------------------XXX------------
-------------------------------------------------------------------------------E----------------------------------------------------------------------------------------------------------XXXX------------
----------------------------------------------------------------S------------------------------------------------------------------------------------------------------------------------XXXXX------------
----------------Q---S?SQS---------------------<>---------<>------------------S?S--------------S-----SS----Q--Q--Q-----S----------SS------X-------------XX--X------------SSQS------------XXXXXX------------
--------------------------------------<>------[]---------[]-----------------------------------------------------------------------------XX--XX--------XXX--XX--------------------------XXXXXXX------------
----------------------------<>--------[]------[]---------[]-----------------------------------------------------------------------------XX--XXX-------X-X--XXX-----<>--------------<>--XXXXXXX------------
---------------------E------[]--------[]-E----[]-----E-E-[]------------------------------------E-E--------E-----------------EE-E-E-----XXX--XXXX-----XXXX--XXXX----[]---------EE---[]-XXXXXXXX------------
XXXXXXXXXXXXXXXXXXXXXXXXXXXXXXXXXXXXXXXXXXXXXXXXXXXXXXXXXXXXXXXXXXXXX--XXXXXXXXXXXXXXX---XXXXXXXXXXXXXXXXXXXXXXXXXXXXXXXXXXXXXXXXXXXXXX-XXXXXXXXXXXXXXXXX--XXXXXXXXXXXXXXXXXXXXXXXXXXXXXXXXXXXXXXXXXXXXXXX
