--------------------------------------------------------------------------------------------------------------------------------------------------------------------------------
--------------------------------------------------------------------------------------------------------------------------------------------------------------------------------
------------------------------------------------------------------------------------------------------------------------------------------------?-------------------------------
--------------------------------------------------------------------------------------------------------------------------------------------------------------------------------
--------------------------------------------------------------------------------E-----------------------------------------------------------------------------------------------
--------------------?SS-----------------------------------------------------SSSSSS----S----------------------------------------SSSSS------------------------------XX------------
--------------------------------------------------------------------------------------------------------------------------------------------------SS-------------XXX------------
-------------------------------------------------------------------------------------------------------------------------------------------------------X--------XXXX------------
-----------------------------------------------------------------------------E--------------------------------------------------E-------------SS------XX-------XXXXX------------
--------------------------------QQQQ-------------------SSXSS----------E----SSSSSSS-----E---------------E-----------------------SSSSS-----------------XXX------XXXXXX------------
-----------------E---------------------------E-----------------------<>---------------<>--------------<>-----E------------E-----------X-------------XXXX-----XXXXXXX------------
--------------------------------E------------------------------------[]---------------[]--------------[]----<>-----------<>-----------X------------XXXXX----XXXXXXXX------------
---------------------------------------------------------------------[]---------------[]--------------[]-E--[]-----------[]-----------X-----------XXXXXX---XXXXXXXXX--------X---
XXXXXXXXXXXXXXXXXXXXXXXXXXXXXXXXXXXXXXXXXXXXXXXXXXXXXXXXXXXXXXXXXX--XXXXXXXXXXXXXXXXXXXXXXXXXXXXXXXXXXXXXXXXXXXXXXXXXXXXXXXXXXXXXXXXXXXXXXXXXXXXX-XXXXXXXXXXXXXXXXXXXXXXXXXXXXXX
