------------------------------------------------------------------------------------------------------------------------------------------------------------------------------------------------------------------------------
------------------------------------------------------------------------------------------------------------------------------------------------------------------------------------------------------------------------------
------------------------------------------------------------------------------------------------------------------------------------------------------------------------------------------------------------------------------
------------------------------------------------------------------------------------------------------------------------------------------------------------------------------------------------------------------------------
------------------------------------------------------------------------------------------------------------------------------------------------------------------------------------------------------------------------------
------------------Q--------------------------------------Q-Q-------------------------S-------------------------------------------------------QQQQ---------------------------------------------------------------XX------------
---------------------------------------------------------------------------------------------------------------------------------------------------------------------------------------------------------------XXX------------
--------------------------------------------------------------------------------------------------------------------------------------------------------------------------------------------------------------XXXX------------
--------------------------------------------------------------------------------------------------------------E---------------E------------------------------------------------------------------------------XXXXX------------
---------------E--?--------------------------------------Q-Q-----------------------QQQQ----------------------<>--------------<>------------QQ?SSQQQ---------------------------------------------------------XXXXXX---S--------
--------------<>--------------------------------------------------------------------------------X------------[]--------------[]------------------------------E------------------------X--------------------XXXXXXX------------
--------------[]--------------------------------------------------------------------------------X------------[]--------------[]-----------------------------<>------------------------X-------------------XXXXXXXX------------
--------------[]--------------------------------------------------------------------------------X------------[]--------------[]-----------------------------[]------------------------X------------------XXXXXXXXX--------X---
XXXXXXXXXXXXXXXXXXXXXXXXX--XXXXXXXXXXXXXXXXXXXXXXXXXXXXXXXXXXXXXXXXXXXX----XXXXXXXXXXXXXXXXXXXXXXXXXXXXXXXXXXXXXXXXXXXXXXXXXXXXXXXXXXXXXXXXXXX--XXXXXXXXXXXXXXXXXXXXXXX---XXX--XXXXXXXX--XXXXXXXXXXXXXXXXXXXXXXXXXXXXXXXXXXXXX
