----------------------------------------------------------------------------------------------------------------------------------------------------------------------------------------------------------------------------------------------------
----------------------------------------------------------------------------------------------------------------------------------------------------------------------------------------------------------------------------------------------------
------------------------------------------------------------------------------------------------------------------------------------------------------------------------------------------------------------------------XXXX------------------------
-------------------------------------------------------------------------------------------------------------------------------------------------------------------------------------------------------------------------[]-------------------------
-------------------------------------------------------------------------------------------------------------------------------------------------------------------------------------------------------------------------[]---------E---------------
--------------------------------------------------------------------------E-------------------XX------------------------QQQ?QQQQQQQQ?QQQQ-----------X--------------------------------------------------------------------<>--------<>---------------
------------X--EX--------------------------------------------------------<>-------------------[]--------------------------------------[]-----------XX----XX------XX---------------------------------------------------------------X[]---------------
------------X---X--------------------------------------------------------[]-------------------[]--------------------------------------[]----------XXXXX-------------------------------------------------------------------E------XX[]---------------
------X---X-X---X--------X-EE----X--------------------------------E------[]-------------------[]--------------------------------------[]---------XXXX---------------------------------------------------------------------------EXX[]---------------
------XSSSX-XSS?X--------XSSSSSSSX--------------------------------------S[]-------------------<>SSSSSS--------------------SSSSSSSSSSS-<>--------XXXXX-----------------------XX-------------------------------------------------<>XX[]------------S--
-------------------------------------------------------------------------[]------------X-------------------------------------------------------XXXXXX----------------------XXX-------------------------------E--------------E-X[]XX[]---------------
-------------------------------------------------------------------------[]------------XX------E-------------------------E---E---------E------XXXXXXX-E-------------------XXXX------------------------------<>-------------<>XX[]XX[]----------SS-SS
-------------------------------------------------------------------------[]------E-----XXXX------E-------------------------------------E-----XXXXXXXX<>------------------XXXXX------------------E-----------[]-------------[]XX[]XX[]--------X-SS-SS
XXXXXXXXXXXXXXXXXXXXXX--XXXXXXXXXXXXEEXEXXXXXXXXXXXXEEXEXXXXXXXXXXXXXXXXXXXXXXXXXX-----XXXXXXXXX<>XXXXXXXXXXXXXXXXXXXXXXXXXXXXXXXXXXXX<>-XXXXXXXXXXXX[]------------------XXXXXXXXXXXXXXXXXXXXXX<>-----------XXXXXXXXXXX----[]XXXXXXXXXXXXXXXXXXXXXX-
