-----------------------------------------------------------------------------------------------------------------------------------------------------------------------------------------------
-----------------------------------------------------------------------------------------------------------------------------------------------------------------------------------------------
-----------------------------------------------------------------------------------------------------------------------------------------------------------------------------------------------
-----------------------------------------------------------------------------------------------------------------------------------------------------------------------------------------------
---------------------------------------------------------------------------------------------------------------------------------------------------------------E-E-----------------------------
-------------------------------------------------------------------------------SSSSSSSSSSSSS-------------------SSS?SSS-------QQ?-------------QQQ?QQQ---------SSSSSSS-SS---------------X-X------
--------------------------------------------------------------------------------------------------------------------------------------------------------------------E---------------EXX--------
------------------------------E----------------------------------------------------------------<>----------------------------------------------E------------------------------------XX-X-------
------------------------------<>------------------<>-----Q--Q--?--------------------SSSSS------[]----------------------------SSS-------------SSSSSSS-------------------------------XXXXX-------
---------------QQQQQQQ------?-[]-------SSSSSS?----[]-----------------S------------SS----------QQQQQQ-----------SSSSSSS----------------<>--------------E--------------<]-------<>---XXXXX-------
-------------------------S----[]------------------[]---------------E------------<>----------------------------------------------------[]-------X------X-------E------[]-X-----[]----XX-X-------
---------------------E--------[]-------------S----[]-----------E----------------[]----------------------------------E-----------------[]-------X----XXX--------------[]-X-----[]----XX-X-------
------------XXE------X----XX--[]------------------XX-----------X-------XXX------[]----E---EE------------E-----------------------------[]----E--XXXXXXXX--------------[]-------[]X---XXXXXXX----
XXXXXXXXXXXXX-XXXXXXX----XXXXXXX-XXXXX--XXXXXXX-----XXXXXXXXXXX-XXXXXX----XXXXXXXXXXXXXXXXXXXXXX-X-XXXXXXXXXXXXXXXXX-X-X--X-------XXXXXXXXXXXXXX-----XXXXXXXXXXXXXXXXXX-------XX-XX----XX--XXXX
