-----------------------------------------------------------------------------------------------------------------------------------------------------------------------------------------------
-----------------------------------------------------------------------------------------------------------------------------------------------------------------------------------------------
-----------------------------------------------------------------------------------------------------------------------------------------------------------------------------------------------
-----------------------------------------------------------------------------------------------------------------------------------------------------------------------------------------------
---------------------------------------------------------------------------------------------------------------------------------------------------------------E-E-----------------------------
-------------------------------------------------------------------------------SSSSSSSSSSSSS-------------------SSS?SSS-------QQ?-------------QQQ?QQQ---------SSSSSSS-SS---------------XXX------
--------------------------------------------------------------------------------------------------------------------------------------------------------------------E---------------EXXX-------
------------------------------E----------------------------------------------------------------<>----------------------------------------------E-----------------------------------XXS-X-------
------------------------------<<------------------<>-----Q--Q--?--------------------SSSSS------[]----------------------------SSS-------------SSSSSSS-------------------------------XXXXX-------
---------------QQQQQQQ------?-[]-------SSSSSS?---->]-----------------S------------SS----------QQQQQQ-----------SSSSSSS----------------<>--------------E--------------<X-------<>---XXXXXX------
-------------------------S----[]------------------<----------------E------------<>----------------------------------------------------[]-------[----XXX-------E------[XXX-----Q]----XX-XX------
---------------------E--------[E-------------S----[]-----------E----------------[-----------------------------------E-----------------X]------XXXXXXXXXX-------------[Q-X-----[<---XXX-XX------
-----------XXXE------X----XXX-[]------------------XX--X---X--XXX-------XXX------]]----E---EE------------E------------X----------------[]----E--XXXXXXXX-------------X[]-------[XX---XXXXXXX----
XXXXXXXXXXXXXXXXXXXXXX---XXXXXXX-XXXXX--XXXXXXX---XXXXXXXXXXXXXXXXXXXX---XXXXXXXXXXXXXXXXXXXXXXX-X-XXXXXXXXXXXXXXXXX-X-X--X-------XXXXXXXXXXXXXXXXXXXXXXXXXXXXXXXXXXXXX-------XX-XXXXX-XXXXXXXX
